100 70
****************************************************************************************************
*                                                                                                  *
*                                                                                                  *
*                                                                                                  *
*                                                                                                  *
*                                                                                                  *
*                                                                                                  *
*                                                                                                  *
*                                                                                                  *
*                                                                                                  *
*                                                                                                  *
*                                                                                                  *
*************************************************                                                  *
*************************************************                                                  *
*                                                                                                  *
*                                                                                                  *
*                                                                                                  *
*                                                                                                  *
*                                     *                                                            *
*                                     *                                                            *
*                                     *                                                            *
*                                     *                                                            *
*                                     *                                                            *
*                   ************************                                                       *
*                   *                      *                                                       *
*                   *                      *                                                       *
*                   *                      *                                                       *
*                   *                      *                                                       *
*                   *                      *                                                       *
*                   ************************                                                       *
*                        *                                                                         *
*                        *                                                                         *
*                        *                                                                         *
*                        *                                                                         *
*                        *                                                                         *
*                                                                                                  *
*                                                                                                  *
*                                                                                                  *
*                                                     ***                                          *
*                                                     ***                                          *
*                                                     ***                                          *
*                                                     ***                                          *
*                                                     ***                                          *
**                                               ***************************************************
*                                                                                                  *
*                                                                                                  *
*                                                                                                  *
*                                                                                                  *
*                                                                                                  *
*                                                                                                  *
*                                                                             ***                  *
*                                                                             ***                  *
*                                                                             ***                  *
*                                                                             ***                  *
*                                                                             ***                  *
*                       ***                                                   ***                  *
*                       ***                                                   ***                  *
*                       ***                                                   ***                  *
*                       ***                                                   ***                  *
*                       ***                                                   ***                  *
*                   ****             ******     ********                    ************************
*               *****                     *******       *********************                      *
*          *****                                                                                   *
*       ****                                                                                       *
*   ****                                                                                           *
****                                                                                               *
*                                                                                                  *
*                                                                                                  *
****************************************************************************************************
