60 20
############################################################
#                                                          #
#                                                          #
#                                                          #
#                                                          #
#                                                          #
#                                                          #
#                                                          #
#                                                          #
#                                                          #
#                                             2            #
#                                      ##############      #
#                                                          #
#                                                          #
#                                                          #
#              1                                           #
#         ############                                     #
#                                                          #
#                                                          #
############################################################